Term	Grupo
intraciliary transport	CMD exclusivo
intraciliary retrograde transport	CMD exclusivo
positive regulation of smoothened signaling pathway	CMD exclusivo
retina layer formation	CMD exclusivo
negative regulation of mitotic nuclear division	CMD exclusivo
RNA splicing, via endonucleolytic cleavage and ligation	CMD exclusivo
negative regulation of mitotic cell cycle	CMD exclusivo
negative regulation of nuclear division	CMD exclusivo
mitotic cell cycle checkpoint signaling	CMD exclusivo
non-canonical Wnt signaling pathway	CMD exclusivo
mitotic spindle assembly checkpoint signaling	CMD exclusivo
spindle assembly checkpoint signaling	CMD exclusivo
mitotic spindle checkpoint signaling	CMD exclusivo
positive regulation of stem cell population maintenance	CMD exclusivo
spindle checkpoint signaling	CMD exclusivo
negative regulation of sister chromatid segregation	CMD exclusivo
negative regulation of mitotic sister chromatid segregation	CMD exclusivo
negative regulation of mitotic metaphase/anaphase transition	CMD exclusivo
negative regulation of mitotic sister chromatid separation	CMD exclusivo
negative regulation of smoothened signaling pathway	CMD exclusivo
negative regulation of metaphase/anaphase transition of cell cycle	CMD exclusivo
negative regulation of chromosome separation	CMD exclusivo
negative regulation of chromosome segregation	CMD exclusivo
regulation of chromosome separation	CMD exclusivo
metaphase chromosome alignment	CMD exclusivo
regulation of T cell differentiation	CMD exclusivo
negative regulation of mitotic cell cycle phase transition	CMD exclusivo
regulation of mitotic sister chromatid segregation	CMD exclusivo
regulation of lymphocyte differentiation	CMD exclusivo
positive regulation of leukocyte differentiation	CMD exclusivo
positive regulation of hemopoiesis	CMD exclusivo
chromosome separation	CMD exclusivo
regulation of mitotic sister chromatid separation	CMD exclusivo
establishment of chromosome localization	CMD exclusivo
polarized epithelial cell differentiation	CMD exclusivo
mitotic sister chromatid separation	CMD exclusivo
endocytic recycling	CMD exclusivo
regulation of nuclear division	CMD exclusivo
regulation of non-canonical Wnt signaling pathway	CMD exclusivo
Wnt signaling pathway, planar cell polarity pathway	CMD exclusivo
chromosome localization	CMD exclusivo
T cell differentiation	CMD exclusivo
cell cycle checkpoint signaling	CMD exclusivo
regulation of Wnt signaling pathway, planar cell polarity pathway	CMD exclusivo
phosphatidylinositol dephosphorylation	CMD exclusivo
positive regulation of lymphocyte activation	CMD exclusivo
positive regulation of cell adhesion	CMD exclusivo
regulation of cell junction assembly	CMD exclusivo
embryonic forelimb morphogenesis	CMD exclusivo
establishment of epithelial cell polarity	CMD exclusivo
transcription initiation at RNA polymerase I promoter	CMD exclusivo
transcription initiation-coupled chromatin remodeling	CMD exclusivo
transcription preinitiation complex assembly	CMD exclusivo
host-mediated perturbation of symbiont process	CMD exclusivo
nucleosome organization	CMD exclusivo
cortical cytoskeleton organization	CMD exclusivo
negative regulation of cell cycle process	CMD exclusivo
protein localization to postsynaptic specialization membrane	CMD exclusivo
neurotransmitter receptor localization to postsynaptic specialization membrane	CMD exclusivo
positive regulation of gene expression, epigenetic	CMD exclusivo
gap junction assembly	CMD exclusivo
odontoblast differentiation	CMD exclusivo
positive regulation of cell morphogenesis	CMD exclusivo
embryonic camera-type eye development	CMD exclusivo
negative regulation of cell cycle	CMD exclusivo
intraciliary anterograde transport	CMD exclusivo
craniofacial suture morphogenesis	CMD exclusivo
regulation of neurotransmitter receptor localization to postsynaptic specialization membrane	CMD exclusivo
positive regulation of leukocyte activation	CMD exclusivo
vocalization behavior	CMD exclusivo
homeostasis of number of cells within a tissue	CMD exclusivo
positive regulation of T cell activation	CMD exclusivo
positive regulation of BMP signaling pathway	CMD exclusivo
forelimb morphogenesis	CMD exclusivo
amino acid metabolic process	CM exclusivo
generation of precursor metabolites and energy	CM exclusivo
energy derivation by oxidation of organic compounds	CM exclusivo
cellular respiration	CM exclusivo
aerobic respiration	CM exclusivo
neuromuscular process	CM exclusivo
nucleoside phosphate biosynthetic process	CM exclusivo
mitochondrion organization	CM exclusivo
oxidative phosphorylation	CM exclusivo
purine nucleoside triphosphate metabolic process	CM exclusivo
nucleoside triphosphate metabolic process	CM exclusivo
tRNA aminoacylation for protein translation	CM exclusivo
purine ribonucleoside triphosphate metabolic process	CM exclusivo
ribonucleoside triphosphate metabolic process	CM exclusivo
ATP metabolic process	CM exclusivo
purine nucleotide metabolic process	CM exclusivo
tRNA aminoacylation	CM exclusivo
purine-containing compound biosynthetic process	CM exclusivo
ribose phosphate metabolic process	CM exclusivo
purine ribonucleotide metabolic process	CM exclusivo
amino acid activation	CM exclusivo
ribonucleotide metabolic process	CM exclusivo
respiratory electron transport chain	CM exclusivo
NADH dehydrogenase complex assembly	CM exclusivo
mitochondrial respiratory chain complex I assembly	CM exclusivo
mitochondrial respiratory chain complex assembly	CM exclusivo
ATP biosynthetic process	CM exclusivo
purine nucleoside triphosphate biosynthetic process	CM exclusivo
purine ribonucleoside triphosphate biosynthetic process	CM exclusivo
electron transport chain	CM exclusivo
ATP synthesis coupled electron transport	CM exclusivo
mitochondrial ATP synthesis coupled electron transport	CM exclusivo
proton motive force-driven ATP synthesis	CM exclusivo
ribonucleoside triphosphate biosynthetic process	CM exclusivo
nucleoside triphosphate biosynthetic process	CM exclusivo
locomotory behavior	CM exclusivo
proton motive force-driven mitochondrial ATP synthesis	CM exclusivo
cognition	CM exclusivo
regulation of membrane potential	CM exclusivo
mitochondrial electron transport, NADH to ubiquinone	CM exclusivo
purine ribonucleotide biosynthetic process	CM exclusivo
nucleotide biosynthetic process	CM exclusivo
neuron apoptotic process	CM exclusivo
aerobic electron transport chain	CM exclusivo
proton transmembrane transport	CM exclusivo
purine nucleotide biosynthetic process	CM exclusivo
ribose phosphate biosynthetic process	CM exclusivo
ribonucleotide biosynthetic process	CM exclusivo
adult locomotory behavior	CM exclusivo
learning or memory	CM exclusivo
regulation of neuron apoptotic process	CM exclusivo
ensheathment of neurons	CM exclusivo
axon ensheathment	CM exclusivo
myelination	CM exclusivo
water-soluble vitamin metabolic process	CM exclusivo
adult behavior	CM exclusivo
alpha-amino acid metabolic process	CM exclusivo
dolichol-linked oligosaccharide biosynthetic process	CM exclusivo
negative regulation of neuron apoptotic process	CM exclusivo
establishment of protein localization to organelle	CM exclusivo
organic acid catabolic process	CM exclusivo
carboxylic acid catabolic process	CM exclusivo
small molecule catabolic process	CM exclusivo
branched-chain amino acid metabolic process	CM exclusivo
muscle system process	CM exclusivo
peroxisome organization	CM exclusivo
branched-chain amino acid catabolic process	CM exclusivo
peroxisomal membrane transport	CM exclusivo
peroxisomal transport	CM exclusivo
vesicle localization	CM exclusivo
regulation of nervous system development	CM exclusivo
mitochondrial RNA metabolic process	CM exclusivo
protein N-linked glycosylation	CM exclusivo
amide metabolic process	CM exclusivo
vitamin metabolic process	CM exclusivo
protein N-linked glycosylation via asparagine	CM exclusivo
cellular catabolic process	CM exclusivo
response to metal ion	CM exclusivo
membrane lipid metabolic process	CM exclusivo
learning	CM exclusivo
central nervous system neuron development	CM exclusivo
neuromuscular process controlling posture	CM exclusivo
response to oxidative stress	CM exclusivo
glycolipid metabolic process	CM exclusivo
action potential	CM exclusivo
transmission of nerve impulse	CM exclusivo
liposaccharide metabolic process	CM exclusivo
adult walking behavior	CM exclusivo
muscle contraction	CM exclusivo
subpallium development	CM exclusivo
protein import into peroxisome matrix	CM exclusivo
regulation of neurogenesis	CM exclusivo
amino acid catabolic process	CM exclusivo
regulation of synaptic plasticity	CM exclusivo
regulation of postsynaptic membrane potential	CM exclusivo
protein localization to peroxisome	CM exclusivo
establishment of protein localization to peroxisome	CM exclusivo
proteinogenic amino acid metabolic process	CM exclusivo
sulfur compound metabolic process	CM exclusivo
cell fate commitment	CM exclusivo
neurotransmitter transport	CM exclusivo
mitochondrial gene expression	CM exclusivo
establishment of vesicle localization	CM exclusivo
L-amino acid metabolic process	CM exclusivo
regulation of neuron projection development	CM exclusivo
diencephalon development	CM exclusivo
vesicle-mediated transport in synapse	CM exclusivo
endocrine system development	CM exclusivo
striatum development	CM exclusivo
protein transmembrane import into intracellular organelle	CM exclusivo
regulation of supramolecular fiber organization	CM exclusivo
cerebellar cortex development	CM exclusivo
response to radiation	CM exclusivo
macroautophagy	CM exclusivo
peripheral nervous system development	CM exclusivo
neuronal action potential	CM exclusivo
forebrain neuron differentiation	CM exclusivo
maintenance of cell number	CM exclusivo
neuromuscular process controlling balance	CM exclusivo
neuron fate commitment	CM exclusivo
regulation of neuronal synaptic plasticity	CM exclusivo
positive regulation of nervous system development	CM exclusivo
stem cell differentiation	CM exclusivo
response to oxygen levels	CM exclusivo
striated muscle contraction	CM exclusivo
positive regulation of neurogenesis	CM exclusivo
regulation of cellular component size	CM exclusivo
synaptic transmission, glutamatergic	CM exclusivo
regulation of neuron differentiation	CM exclusivo
muscle cell differentiation	CM exclusivo
fatty acid beta-oxidation	CM exclusivo
tricarboxylic acid cycle	CM exclusivo
sulfur compound biosynthetic process	CM exclusivo
regulation of presynaptic membrane potential	CM exclusivo
response to light stimulus	CM exclusivo
regulation of synapse structure or activity	CM exclusivo
amide biosynthetic process	CM exclusivo
pyridine-containing compound metabolic process	CM exclusivo
memory	CM exclusivo
signal release	CM exclusivo
amino acid biosynthetic process	CM exclusivo
glycerolipid metabolic process	CM exclusivo
membrane lipid biosynthetic process	CM exclusivo
regulation of synapse organization	CM exclusivo
collagen fibril organization	CM exclusivo
vacuole organization	CM exclusivo
stem cell population maintenance	CM exclusivo
potassium ion transmembrane transport	CM exclusivo
determination of adult lifespan	CM exclusivo
protein complex oligomerization	CM exclusivo
lipid catabolic process	CM exclusivo
oligodendrocyte development	CM exclusivo
Schwann cell differentiation	CM exclusivo
tRNA processing	CM exclusivo
cobalamin metabolic process	CM exclusivo
carbohydrate catabolic process	CM exclusivo
protein tetramerization	CM exclusivo
cell fate specification	CM exclusivo
fatty acid catabolic process	CM exclusivo
Schwann cell development	CM exclusivo
dopamine metabolic process	CM exclusivo
nucleotide-sugar metabolic process	CM exclusivo
non-proteinogenic amino acid metabolic process	CM exclusivo
import across plasma membrane	CM exclusivo
thyroid gland development	CM exclusivo
alcohol metabolic process	CM exclusivo
glutamate receptor signaling pathway	CM exclusivo
fatty acid oxidation	CM exclusivo
startle response	CM exclusivo
protein targeting	CM exclusivo
nephron development	CM exclusivo
maintenance of location	CM exclusivo
skeletal muscle tissue development	CM exclusivo
monosaccharide metabolic process	CM exclusivo
neuroblast proliferation	CM exclusivo
modified amino acid metabolic process	CM exclusivo
glycolipid biosynthetic process	CM exclusivo
postsynapse organization	CM exclusivo
oligodendrocyte differentiation	CM exclusivo
protein localization to cell periphery	CM exclusivo
tRNA threonylcarbamoyladenosine metabolic process	CM exclusivo
potassium ion transport	CM exclusivo
nerve development	CM exclusivo
dicarboxylic acid metabolic process	CM exclusivo
hindbrain morphogenesis	CM exclusivo
inorganic anion transmembrane transport	CM exclusivo
lysosome organization	CM exclusivo
lytic vacuole organization	CM exclusivo
lipid modification	CM exclusivo
positive regulation of synaptic transmission	CM exclusivo
maintenance of location in cell	CM exclusivo
protein localization to nucleus	CM exclusivo
dendrite development	CM exclusivo
cellular response to chemical stress	CM exclusivo
L-amino acid biosynthetic process	CM exclusivo
multicellular organismal response to stress	CM exclusivo
purine-containing compound catabolic process	CM exclusivo
cerebellum morphogenesis	CM exclusivo
regulation of cell size	CM exclusivo
pigmentation	CM exclusivo
acidic amino acid transport	CM exclusivo
protein transmembrane transport	CM exclusivo
cytochrome complex assembly	CM exclusivo
cerebellar cortex morphogenesis	CM exclusivo
tetrapyrrole metabolic process	CM exclusivo
mitochondrial transmembrane transport	CM exclusivo
pyridine nucleotide metabolic process	CM exclusivo
nicotinamide nucleotide metabolic process	CM exclusivo
lipid oxidation	CM exclusivo
thioester biosynthetic process	CM exclusivo
acyl-CoA biosynthetic process	CM exclusivo
amino acid transport	CM exclusivo
heart valve development	CM exclusivo
organophosphate catabolic process	CM exclusivo
body morphogenesis	CM exclusivo
regulation of neuron migration	CM exclusivo
mitochondrial transport	CM exclusivo
response to decreased oxygen levels	CM exclusivo
striated muscle cell differentiation	CM exclusivo
neuron projection maintenance	CM exclusivo
hexose metabolic process	CM exclusivo
nucleoside phosphate catabolic process	CM exclusivo
neuron projection organization	CM exclusivo
developmental growth involved in morphogenesis	CM exclusivo
muscle cell development	CM exclusivo
associative learning	CM exclusivo
inorganic anion transport	CM exclusivo
multicellular organismal movement	CM exclusivo
face development	CM exclusivo
regulation of protein-containing complex assembly	CM exclusivo
chemical synaptic transmission, postsynaptic	CM exclusivo
carbohydrate derivative catabolic process	CM exclusivo
regulation of long-term neuronal synaptic plasticity	CM exclusivo
lung epithelium development	CM exclusivo
alcohol biosynthetic process	CM exclusivo
response to hypoxia	CM exclusivo
nucleotide-sugar biosynthetic process	CM exclusivo
alpha-amino acid catabolic process	CM exclusivo
negative regulation of organelle organization	CM exclusivo
central nervous system neuron axonogenesis	CM exclusivo
ribonucleotide catabolic process	CM exclusivo
axo-dendritic transport	CM exclusivo
excitatory postsynaptic potential	CM exclusivo
visual behavior	CM exclusivo
neuron maturation	CM exclusivo
neurotransmitter secretion	CM exclusivo
signal release from synapse	CM exclusivo
alpha-amino acid biosynthetic process	CM exclusivo
social behavior	CM exclusivo
proteoglycan metabolic process	CM exclusivo
heart process	CM exclusivo
musculoskeletal movement	CM exclusivo
phenol-containing compound metabolic process	CM exclusivo
actin-mediated cell contraction	CM exclusivo
acyl-CoA metabolic process	CM exclusivo
thioester metabolic process	CM exclusivo
pyruvate metabolic process	CM exclusivo
dopamine biosynthetic process	CM exclusivo
mitochondrial tRNA processing	CM exclusivo
visual learning	CM exclusivo
regulation of macroautophagy	CM exclusivo
membraneless organelle assembly	CM exclusivo
dicarboxylic acid transport	CM exclusivo
stem cell proliferation	CM exclusivo
chromatin looping	CM exclusivo
mitochondrial RNA processing	CM exclusivo
diol biosynthetic process	CM exclusivo
positive regulation of neuron differentiation	CM exclusivo
glial cell proliferation	CM exclusivo
astrocyte differentiation	CM exclusivo
establishment of protein localization to membrane	CM exclusivo
neural crest cell development	CM exclusivo
head morphogenesis	CM exclusivo
ionotropic glutamate receptor signaling pathway	CM exclusivo
monocarboxylic acid catabolic process	CM exclusivo
biological process involved in intraspecies interaction between organisms	CM exclusivo
positive regulation of excitatory postsynaptic potential	CM exclusivo
intracellular protein transmembrane transport	CM exclusivo
purine ribonucleotide catabolic process	CM exclusivo
inorganic cation import across plasma membrane	CM exclusivo
inorganic ion import across plasma membrane	CM exclusivo
stem cell development	CM exclusivo
aorta development	CM exclusivo
regulation of synaptic transmission, glutamatergic	CM exclusivo
microtubule polymerization or depolymerization	CM exclusivo
proteinogenic amino acid biosynthetic process	CM exclusivo
heparan sulfate proteoglycan metabolic process	CM exclusivo
L-glutamate import	CM exclusivo
response to starvation	CM exclusivo
developmental cell growth	CM exclusivo
intracellular copper ion homeostasis	CM exclusivo
non-proteinogenic amino acid biosynthetic process	CM exclusivo
catecholamine metabolic process	CM exclusivo
catechol-containing compound metabolic process	CM exclusivo
noradrenergic neuron differentiation	CM exclusivo
trachea morphogenesis	CM exclusivo
regulation of generation of precursor metabolites and energy	CM exclusivo
artery morphogenesis	CM exclusivo
sodium ion transport	CM exclusivo
positive regulation of protein localization	CM exclusivo
nucleotide catabolic process	CM exclusivo
synaptic vesicle localization	CM exclusivo
purine nucleotide catabolic process	CM exclusivo
actin filament-based movement	CM exclusivo
heart contraction	CM exclusivo
axonal transport	CM exclusivo
long-term synaptic potentiation	CM exclusivo
copper ion homeostasis	CM exclusivo
ligand-gated ion channel signaling pathway	CM exclusivo
modulation of excitatory postsynaptic potential	CM exclusivo
response to peptide hormone	CM exclusivo
monoatomic anion transport	CM exclusivo
glucose homeostasis	CM exclusivo
cardiac muscle cell action potential	CM exclusivo
cardiac muscle cell contraction	CM exclusivo
mesenchymal cell migration	CM exclusivo
spindle organization	CM exclusivo
neurotransmitter uptake	CM exclusivo
heparan sulfate proteoglycan biosynthetic process	CM exclusivo
pteridine-containing compound metabolic process	CM exclusivo
iron-sulfur cluster assembly	CM exclusivo
central nervous system projection neuron axonogenesis	CM exclusivo
metallo-sulfur cluster assembly	CM exclusivo
carbohydrate homeostasis	CM exclusivo
2-oxoglutarate metabolic process	CM exclusivo
regulation of nervous system process	CM exclusivo
regulation of autophagy of mitochondrion	CM exclusivo
monoatomic anion transmembrane transport	CM exclusivo
insulin-like growth factor receptor signaling pathway	CM exclusivo
vesicle organization	CM exclusivo
cellular response to nutrient levels	CM exclusivo
cell growth	CM exclusivo
regulation of ATP metabolic process	CM exclusivo
response to glucose	CM exclusivo
cardiac muscle cell action potential involved in contraction	CM exclusivo
gastrulation	CM exclusivo
tube formation	CM exclusivo
exploration behavior	CM exclusivo
pyramidal neuron differentiation	CM exclusivo
vacuolar transport	CM exclusivo
fatty acid beta-oxidation using acyl-CoA dehydrogenase	CM exclusivo
endoderm development	CM exclusivo
regulation of purine nucleotide metabolic process	CM exclusivo
membrane depolarization	CM exclusivo
glycolipid catabolic process	CM exclusivo
regulation of protein localization to cell periphery	CM exclusivo
carboxylic acid transmembrane transport	CM exclusivo
secondary alcohol metabolic process	CM exclusivo
intracellular iron ion homeostasis	CM exclusivo
tRNA modification	CM exclusivo
regulation of autophagy	CM exclusivo
fatty acid metabolic process	CM exclusivo
regulation of nucleotide metabolic process	CM exclusivo
endosome organization	CM exclusivo
skeletal muscle fiber development	CM exclusivo
mesenchymal cell differentiation	CM exclusivo
trachea development	CM exclusivo
protein polymerization	CM exclusivo
microtubule cytoskeleton organization involved in mitosis	CM exclusivo
neuron projection extension	CM exclusivo
neural crest cell migration	CM exclusivo
somatic stem cell population maintenance	CM exclusivo
mesenchyme development	CM exclusivo
regulation of microtubule polymerization or depolymerization	CM exclusivo
retrograde axonal transport	CM exclusivo
catechol-containing compound biosynthetic process	CM exclusivo
catecholamine biosynthetic process	CM exclusivo
cellular response to metal ion	CM exclusivo
mitotic sister chromatid cohesion	CM exclusivo
response to hexose	CM exclusivo
cerebellar cortex formation	CM exclusivo
response to carbohydrate	CM exclusivo
chloride transport	CM exclusivo
response to monosaccharide	CM exclusivo
regulation of extracellular matrix organization	CM exclusivo
regulation of gliogenesis	CM exclusivo
protein localization to mitochondrion	CM exclusivo
type 2 mitophagy	CM exclusivo
positive regulation of amine transport	CM exclusivo
Ras protein signal transduction	CM exclusivo
organic acid transmembrane transport	CM exclusivo
immune system development	CM exclusivo
calcium ion transport	CM exclusivo
regulation of stem cell proliferation	CM exclusivo
regulation of neuroblast proliferation	CM exclusivo
chloride transmembrane transport	CM exclusivo
synapse assembly	CM exclusivo
organic anion transport	CM exclusivo
intracellular glucose homeostasis	CM exclusivo
import into nucleus	CM exclusivo
dermatan sulfate proteoglycan metabolic process	CM exclusivo
aminoacyl-tRNA metabolism involved in translational fidelity	CM exclusivo
receptor metabolic process	CM exclusivo
protein targeting to peroxisome	CM exclusivo
learned vocalization behavior or vocal learning	CM exclusivo
cellular response to oxidative stress	CM exclusivo
regulation of protein localization to membrane	CM exclusivo
glycosaminoglycan biosynthetic process	CM exclusivo
thymus development	CM exclusivo
diol metabolic process	CM exclusivo
protein homooligomerization	CM exclusivo
dendritic spine organization	CM exclusivo
glycolytic process	CM exclusivo
amine transport	CM exclusivo
protein import into nucleus	CM exclusivo
response to mechanical stimulus	CM exclusivo
cellular response to monosaccharide stimulus	CM exclusivo
C4-dicarboxylate transport	CM exclusivo
cerebellar Purkinje cell layer development	CM exclusivo
positive regulation of autophagy of mitochondrion	CM exclusivo
lymphoid progenitor cell differentiation	CM exclusivo
melanosome localization	CM exclusivo
amide transport	CM exclusivo
regulation of neurotransmitter transport	CM exclusivo
regulation of neural precursor cell proliferation	CM exclusivo
mitochondrial translation	CM exclusivo
mesenchymal cell proliferation	CM exclusivo
autonomic nervous system development	CM exclusivo
regulation of mitophagy	CM exclusivo
amyloid fibril formation	CM exclusivo
protein localization to extracellular region	CM exclusivo
cellular response to glucose stimulus	CM exclusivo
peptide hormone secretion	CM exclusivo
polysaccharide metabolic process	CM exclusivo
pyridine-containing compound catabolic process	CM exclusivo
establishment of protein localization to mitochondrion	CM exclusivo
cardiac muscle tissue development	CM exclusivo
response to auditory stimulus	CM exclusivo
pituitary gland development	CM exclusivo
circadian rhythm	CM exclusivo
ADP catabolic process	CM exclusivo
epithelial tube formation	CM exclusivo
maintenance of protein location	CM exclusivo
motor behavior	CM exclusivo
acetyl-CoA biosynthetic process	CM exclusivo
purine nucleoside monophosphate biosynthetic process	CM exclusivo
regulation of oxidative stress-induced neuron intrinsic apoptotic signaling pathway	CM exclusivo
membrane lipid catabolic process	CM exclusivo
muscle cell cellular homeostasis	CM exclusivo
pigment granule localization	CM exclusivo
positive regulation of mitophagy	CM exclusivo
aorta morphogenesis	CM exclusivo
biogenic amine metabolic process	CM exclusivo
cellular response to carbohydrate stimulus	CM exclusivo
cellular response to hexose stimulus	CM exclusivo
cardiac muscle contraction	CM exclusivo
pteridine-containing compound biosynthetic process	CM exclusivo
regulation of pH	CM exclusivo
regulation of monoatomic ion transport	CM exclusivo
establishment of protein localization to extracellular region	CM exclusivo
myotube cell development	CM exclusivo
regulation of telomere maintenance	CM exclusivo
regulation of amine transport	CM exclusivo
regulation of mesenchymal cell proliferation	CM exclusivo
L-glutamate transmembrane transport	CM exclusivo
cartilage development	CM exclusivo
receptor recycling	CM exclusivo
pyridine nucleotide catabolic process	CM exclusivo
protein localization to plasma membrane	CM exclusivo
peptidyl-serine phosphorylation	CM exclusivo
maintenance of protein location in cell	CM exclusivo
response to amine	CM exclusivo
positive regulation of neural precursor cell proliferation	CM exclusivo
polyprenol metabolic process	CM exclusivo
pyramidal neuron development	CM exclusivo
establishment of sister chromatid cohesion	CM exclusivo
action potential propagation	CM exclusivo
sphingolipid metabolic process	CM exclusivo
ceramide metabolic process	CM exclusivo
calcium ion transmembrane transport	CM exclusivo
regulation of translational fidelity	CM exclusivo
neural nucleus development	CM exclusivo
positive regulation of DNA-templated transcription initiation	CM exclusivo
peptide secretion	CM exclusivo
purine nucleoside diphosphate catabolic process	CM exclusivo
purine ribonucleoside diphosphate catabolic process	CM exclusivo
synaptic vesicle exocytosis	CM exclusivo
response to alkaloid	CM exclusivo
hematopoietic or lymphoid organ development	CM exclusivo
striated muscle cell development	CM exclusivo
protein targeting to mitochondrion	CM exclusivo
nucleoside diphosphate catabolic process	CM exclusivo
protein secretion	CM exclusivo
cell differentiation involved in kidney development	CM exclusivo
synaptic vesicle transport	CM exclusivo
reactive oxygen species metabolic process	CM exclusivo
mismatch repair	CM exclusivo
intra-Golgi vesicle-mediated transport	CM exclusivo
epigenetic programming of gene expression	CM exclusivo
positive regulation of oxidoreductase activity	CM exclusivo
neurotransmitter reuptake	CM exclusivo
response to toxic substance	CM exclusivo
canonical Wnt signaling pathway	CM exclusivo
response to reactive oxygen species	CM exclusivo
regulation of small molecule metabolic process	CM exclusivo
negative regulation of protein-containing complex assembly	CM exclusivo
chondroitin sulfate proteoglycan metabolic process	CM exclusivo
positive regulation of extracellular matrix organization	CM exclusivo
inner mitochondrial membrane organization	CM exclusivo
otic vesicle development	CM exclusivo
regulation of glycolytic process	CM exclusivo
regulation of nucleotide catabolic process	CM exclusivo
regulation of purine nucleotide catabolic process	CM exclusivo
epigenetic regulation of gene expression	CM exclusivo
nucleoside diphosphate metabolic process	CM exclusivo
glutamine family amino acid metabolic process	CM exclusivo
telomere capping	CM exclusivo
cerebral cortex neuron differentiation	CM exclusivo
central nervous system myelination	CM exclusivo
axon ensheathment in central nervous system	CM exclusivo
proteoglycan biosynthetic process	CM exclusivo
sodium ion transmembrane transport	CM exclusivo
cellular response to fibroblast growth factor stimulus	CM exclusivo
acetyl-CoA metabolic process	CM exclusivo
neuron fate specification	CM exclusivo
regulation of carbohydrate catabolic process	CM exclusivo
protein homotetramerization	CM exclusivo
neuron cellular homeostasis	CM exclusivo
purine ribonucleoside monophosphate biosynthetic process	CM exclusivo
cerebellar Purkinje cell layer morphogenesis	CM exclusivo
regulation of dopamine metabolic process	CM exclusivo
regulation of catecholamine metabolic process	CM exclusivo
non-proteinogenic amino acid catabolic process	CM exclusivo
ribonucleoside diphosphate catabolic process	CM exclusivo
ADP metabolic process	CM exclusivo
SNARE complex assembly	CM exclusivo
neuron intrinsic apoptotic signaling pathway in response to oxidative stress	CM exclusivo
glycosphingolipid catabolic process	CM exclusivo
amine metabolic process	CM exclusivo
synaptic vesicle endocytosis	CM exclusivo
regulation of actin filament-based process	CM exclusivo
lysosomal transport	CM exclusivo
mitotic spindle organization	CM exclusivo
peptide transport	CM exclusivo
vitamin transport	CM exclusivo
sphingolipid catabolic process	CM exclusivo
pro-B cell differentiation	CM exclusivo
auditory behavior	CM exclusivo
regulation of timing of cell differentiation	CM exclusivo
peptidyl-serine modification	CM exclusivo
synaptic transmission, cholinergic	CM exclusivo
regulation of lysosomal lumen pH	CM exclusivo
face morphogenesis	CM exclusivo
response to fibroblast growth factor	CM exclusivo
synaptic vesicle recycling	CM exclusivo
regulation of muscle cell differentiation	CM exclusivo
synaptic transmission, GABAergic	CM exclusivo
positive regulation of transcription initiation by RNA polymerase II	CM exclusivo
reactive oxygen species biosynthetic process	CM exclusivo
glucose metabolic process	CM exclusivo
endoplasmic reticulum organization	CM exclusivo
microtubule polymerization	CM exclusivo
nephron tubule development	CM exclusivo
regulation of axonogenesis	CM exclusivo
negative regulation of catabolic process	CM exclusivo
regulation of metal ion transport	CM exclusivo
mitochondrial fission	CM exclusivo
regulation of nucleocytoplasmic transport	CM exclusivo
hormone secretion	CM exclusivo
skeletal muscle contraction	CM exclusivo
carboxylic acid biosynthetic process	CM exclusivo
regulation of actin cytoskeleton organization	CM exclusivo
regulation of reactive oxygen species metabolic process	CM exclusivo
regulation of cellular response to oxidative stress	CM exclusivo
positive regulation of macroautophagy	CM exclusivo
dendrite morphogenesis	CM exclusivo
cristae formation	CM exclusivo
polyol metabolic process	CM exclusivo
myotube differentiation	CM exclusivo
cellular pigmentation	CM exclusivo
regulation of neurotransmitter secretion	CM exclusivo
calcium ion import	CM exclusivo
aminoglycan biosynthetic process	CM exclusivo
mitochondrion localization	CM exclusivo
negative regulation of neurogenesis	CM exclusivo
response to calcium ion	CM exclusivo
transcription by RNA polymerase I	CM exclusivo
cell fate determination	CM exclusivo
organic acid biosynthetic process	CM exclusivo
rhythmic process	CM exclusivo
positive regulation of neuroblast proliferation	CM exclusivo
myelination in peripheral nervous system	CM exclusivo
peripheral nervous system axon ensheathment	CM exclusivo
calcium ion homeostasis	CM exclusivo
positive regulation of establishment of protein localization	CM exclusivo
regulation of protein localization to nucleus	CM exclusivo
regulation of monoatomic ion transmembrane transport	CM exclusivo
lens development in camera-type eye	CM exclusivo
positive regulation of neuron projection development	CM exclusivo
regulation of striated muscle cell differentiation	CM exclusivo
regulation of monoatomic cation transmembrane transport	CM exclusivo
N-terminal protein amino acid acetylation	CM exclusivo
respiratory chain complex III assembly	CM exclusivo
glial cell fate commitment	CM exclusivo
telencephalon regionalization	CM exclusivo
mitochondrial respiratory chain complex III assembly	CM exclusivo
mitochondrial protein processing	CM exclusivo
regulation of development, heterochronic	CM exclusivo
forebrain morphogenesis	CM exclusivo
UV-damage excision repair	CM exclusivo
regulation of type 2 mitophagy	CM exclusivo
ribonucleoside diphosphate metabolic process	CM exclusivo
calcium ion transmembrane import into cytosol	CM exclusivo
autophagy of mitochondrion	CM exclusivo
presynaptic endocytosis	CM exclusivo
carboxylic acid transport	CM exclusivo
synaptic vesicle priming	CM exclusivo
lung alveolus development	CM exclusivo
negative regulation of nervous system development	CM exclusivo
negative regulation of telomere maintenance	CM exclusivo
maintenance of blood-brain barrier	CM exclusivo
biogenic amine biosynthetic process	CM exclusivo
fear response	CM exclusivo
phenol-containing compound biosynthetic process	CM exclusivo
semi-lunar valve development	CM exclusivo
organic acid transport	CM exclusivo
midbrain development	CM exclusivo
heterochromatin formation	CM exclusivo
cranial nerve development	CM exclusivo
melanosome transport	CM exclusivo
response to potassium ion	CM exclusivo
genomic imprinting	CM exclusivo
ubiquinone biosynthetic process	CM exclusivo
regulation of sister chromatid cohesion	CM exclusivo
tRNA decay	CM exclusivo
heparin proteoglycan metabolic process	CM exclusivo
locomotory exploration behavior	CM exclusivo
negative regulation of glial cell proliferation	CM exclusivo
quinone biosynthetic process	CM exclusivo
protein autophosphorylation	CM exclusivo
positive regulation of chromosome organization	CM exclusivo
purine nucleoside diphosphate metabolic process	CM exclusivo
purine ribonucleoside diphosphate metabolic process	CM exclusivo
regulation of DNA-templated transcription initiation	CM exclusivo
gamma-aminobutyric acid signaling pathway	CM exclusivo
respiratory chain complex IV assembly	CM exclusivo
cardiac ventricle morphogenesis	CM exclusivo
spindle assembly	CM exclusivo
cardiac muscle cell differentiation	CM exclusivo
transcription-coupled nucleotide-excision repair	CM exclusivo
pyruvate family amino acid catabolic process	CM exclusivo
neuronal action potential propagation	CM exclusivo
GDP-mannose metabolic process	CM exclusivo
sebaceous gland development	CM exclusivo
epithelial cell proliferation involved in lung morphogenesis	CM exclusivo
mitochondrial RNA modification	CM exclusivo
regulation of cellular pH	CM exclusivo
proteinogenic amino acid catabolic process	CM exclusivo
hepaticobiliary system development	CM exclusivo
insulin secretion	CM exclusivo
cell volume homeostasis	CM exclusivo
regulation of mitochondrial gene expression	CM exclusivo
regulation of peptidyl-serine phosphorylation	CM exclusivo
membrane fission	CM exclusivo
postsynaptic membrane organization	CM exclusivo
amine biosynthetic process	CM exclusivo
Golgi organization	CM exclusivo
membrane docking	CM exclusivo
skeletal muscle adaptation	CM exclusivo
ceramide catabolic process	CM exclusivo
regulation of protein import into nucleus	CM exclusivo
regulation of vacuole organization	CM exclusivo
L-amino acid transport	CM exclusivo
cholesterol metabolic process	CM exclusivo
hormone transport	CM exclusivo
response to endoplasmic reticulum stress	CM exclusivo
response to UV	CM exclusivo
vitamin biosynthetic process	CM exclusivo
chondroitin sulfate metabolic process	CM exclusivo
establishment of melanosome localization	CM exclusivo
sympathetic nervous system development	CM exclusivo
pigment granule transport	CM exclusivo
lysosomal protein catabolic process	CM exclusivo
somatic diversification of immune receptors via somatic mutation	CM exclusivo
ventricular trabecula myocardium morphogenesis	CM exclusivo
pyruvate decarboxylation to acetyl-CoA	CM exclusivo
GMP biosynthetic process	CM exclusivo
mechanosensory behavior	CM exclusivo
regulation of skeletal muscle adaptation	CM exclusivo
random inactivation of X chromosome	CM exclusivo
lactone metabolic process	CM exclusivo
negative regulation of oxidative stress-induced neuron intrinsic apoptotic signaling pathway	CM exclusivo
anterograde axonal transport	CM exclusivo
intracellular lipid transport	CM exclusivo
regulation of intracellular pH	CM exclusivo
mitochondrial membrane organization	CM exclusivo
regulation of canonical Wnt signaling pathway	CM exclusivo
energy reserve metabolic process	CM exclusivo
negative regulation of neuron differentiation	CM exclusivo
regulation of transcription initiation by RNA polymerase II	CM exclusivo
muscle tissue morphogenesis	CM exclusivo
negative regulation of gliogenesis	CM exclusivo
retinal rod cell differentiation	CM exclusivo
L-glutamate import across plasma membrane	CM exclusivo
positive regulation of neuron migration	CM exclusivo
telomere maintenance via telomerase	CM exclusivo
cellular response to peptide hormone stimulus	CM exclusivo
cellular response to starvation	CM exclusivo
embryonic epithelial tube formation	CM exclusivo
regulation of telomere maintenance via telomere lengthening	CM exclusivo
cell maturation	CM exclusivo
polysaccharide biosynthetic process	CM exclusivo
exocytic process	CM exclusivo
positive regulation of mesenchymal cell proliferation	CM exclusivo
regulation of mitochondrial translation	CM exclusivo
cellular response to radiation	CM exclusivo
reproductive structure development	CM exclusivo
regulation of protein transport	CM exclusivo
positive regulation of axonogenesis	CM exclusivo
regulation of transmembrane transport	CM exclusivo
endocardial cushion development	CM exclusivo
endodermal cell differentiation	CM exclusivo
regulation of cellular respiration	CM exclusivo
amino acid import across plasma membrane	CM exclusivo
positive regulation of cell growth	CM exclusivo
cardiocyte differentiation	CM exclusivo
positive regulation of phosphorus metabolic process	CM exclusivo
positive regulation of phosphate metabolic process	CM exclusivo
glial cell migration	CM exclusivo
protein depolymerization	CM exclusivo
protein targeting to vacuole	CM exclusivo
regulation of myelination	CM exclusivo
positive regulation of mitotic nuclear division	CM exclusivo
axon extension	CM exclusivo
purine nucleoside monophosphate metabolic process	CM exclusivo
regulation of amino acid transport	CM exclusivo
transition metal ion transport	CM exclusivo
positive regulation of ATP metabolic process	CM exclusivo
small GTPase-mediated signal transduction	CM exclusivo
negative regulation of supramolecular fiber organization	CM exclusivo
thyroid hormone generation	CM exclusivo
regulation of amine metabolic process	CM exclusivo
establishment of pigment granule localization	CM exclusivo
positive regulation of amino acid transport	CM exclusivo
dendritic spine maintenance	CM exclusivo
positive regulation of long-term synaptic potentiation	CM exclusivo
[2Fe-2S] cluster assembly	CM exclusivo
bronchus development	CM exclusivo
positive regulation of phosphorylation	CM exclusivo
telomere maintenance via telomere lengthening	CM exclusivo
cranial skeletal system development	CM exclusivo
organelle fusion	CM exclusivo
carbohydrate biosynthetic process	CM exclusivo
regulation of mitochondrion organization	CM exclusivo
peptidyl-threonine modification	CM exclusivo
muscle organ morphogenesis	CM exclusivo
oligosaccharide metabolic process	CM exclusivo
metanephros development	CM exclusivo
regulation of protein depolymerization	CM exclusivo
dendritic spine development	CM exclusivo
ubiquinone metabolic process	CM exclusivo
chondroitin sulfate biosynthetic process	CM exclusivo
regulation of amyloid fibril formation	CM exclusivo
regulation of cell growth	CM exclusivo
regulation of protein-containing complex disassembly	CM exclusivo
mitochondrial transcription	CM exclusivo
erythrose 4-phosphate/phosphoenolpyruvate family amino acid metabolic process	CM exclusivo
regulation of amino acid metabolic process	CM exclusivo
regulation of telomere maintenance via telomerase	CM exclusivo
regulation of long-term synaptic potentiation	CM exclusivo
regulation of oxidative stress-induced intrinsic apoptotic signaling pathway	CM exclusivo
negative regulation of cytoskeleton organization	CM exclusivo
positive regulation of secretion by cell	CM exclusivo
reproductive system development	CM exclusivo
ribonucleoside monophosphate metabolic process	CM exclusivo
regulation of muscle system process	CM exclusivo
nucleoside monophosphate biosynthetic process	CM exclusivo
regulation of post-transcriptional gene silencing	CM exclusivo
camera-type eye photoreceptor cell differentiation	CM exclusivo
nucleocytoplasmic transport	CM exclusivo
nuclear transport	CM exclusivo
protein localization to vacuole	CM exclusivo
ureteric bud development	CM exclusivo
response to amino acid	CM exclusivo
myeloid leukocyte differentiation	CM exclusivo
catecholamine transport	CM exclusivo
sulfur compound transport	CM exclusivo
establishment of protein localization to vacuole	CM exclusivo
positive regulation of protein transport	CM exclusivo
methylation	CM exclusivo
intracellular calcium ion homeostasis	CM exclusivo
peptidyl-threonine phosphorylation	CM exclusivo
cell differentiation in hindbrain	CM exclusivo
melanocyte differentiation	CM exclusivo
positive regulation of monooxygenase activity	CM exclusivo
regulation of respiratory gaseous exchange	CM exclusivo
negative regulation of Ras protein signal transduction	CM exclusivo
phosphatidylinositol-mediated signaling	CM exclusivo
chondroitin sulfate proteoglycan biosynthetic process	CM exclusivo
regulation of chromatin organization	CM exclusivo
positive regulation of supramolecular fiber organization	CM exclusivo
response to epidermal growth factor	CM exclusivo
negative regulation of reactive oxygen species metabolic process	CM exclusivo
nucleoside monophosphate metabolic process	CM exclusivo
positive regulation of epithelial to mesenchymal transition	CM exclusivo
positive regulation of protein phosphorylation	CM exclusivo
response to activity	CM exclusivo
glycosaminoglycan metabolic process	CM exclusivo
mesonephric epithelium development	CM exclusivo
mesonephric tubule development	CM exclusivo
glucan metabolic process	CM exclusivo
behavioral defense response	CM exclusivo
calcium ion import across plasma membrane	CM exclusivo
calcium ion import into cytosol	CM exclusivo
response to X-ray	CM exclusivo
thyroid hormone metabolic process	CM exclusivo
lung cell differentiation	CM exclusivo
lung epithelial cell differentiation	CM exclusivo
cellular response to gamma radiation	CM exclusivo
regulation of synaptic vesicle recycling	CM exclusivo
regulation of protein secretion	CM exclusivo
positive regulation of Wnt signaling pathway	CM exclusivo
postsynaptic specialization organization	CM exclusivo
nucleobase metabolic process	CM exclusivo
regulation of intracellular estrogen receptor signaling pathway	CM exclusivo
mitochondrion distribution	CM exclusivo
GABAergic neuron differentiation	CM exclusivo
negative regulation of reactive oxygen species biosynthetic process	CM exclusivo
liver development	CM exclusivo
respiratory gaseous exchange by respiratory system	CM exclusivo
receptor localization to synapse	CM exclusivo
regulation of stem cell differentiation	CM exclusivo
regulation of fibroblast proliferation	CM exclusivo
regulation of protein polymerization	CM exclusivo
receptor clustering	CM exclusivo
adipose tissue development	CM exclusivo
epithelial cell differentiation involved in kidney development	CM exclusivo
urea cycle	CM exclusivo
peroxisome fission	CM exclusivo
phosphate ion transmembrane transport	CM exclusivo
cellular response to increased oxygen levels	CM exclusivo
neuronal ion channel clustering	CM exclusivo
positive regulation of cell size	CM exclusivo
enteric nervous system development	CM exclusivo
skeletal muscle tissue growth	CM exclusivo
dopamine uptake involved in synaptic transmission	CM exclusivo
catecholamine uptake involved in synaptic transmission	CM exclusivo
positive regulation of post-transcriptional gene silencing	CM exclusivo
centromeric sister chromatid cohesion	CM exclusivo
skeletal muscle fiber differentiation	CM exclusivo
excitatory chemical synaptic transmission	CM exclusivo
positive regulation of post-transcriptional gene silencing by RNA	CM exclusivo
positive regulation of miRNA-mediated gene silencing	CM exclusivo
positive regulation of sodium ion transmembrane transporter activity	CM exclusivo
response to insulin	CM exclusivo
glutamine family amino acid biosynthetic process	CM exclusivo
adenohypophysis development	CM exclusivo
regulation of respiratory system process	CM exclusivo
short-chain fatty acid metabolic process	CM exclusivo
organelle inheritance	CM exclusivo
Golgi inheritance	CM exclusivo
seminiferous tubule development	CM exclusivo
sex differentiation	CM exclusivo
amino acid transmembrane transport	CM exclusivo
aortic valve development	CM exclusivo
positive regulation of glial cell differentiation	CM exclusivo
positive regulation of gliogenesis	CM exclusivo
glomerulus development	CM exclusivo
regulation of intracellular steroid hormone receptor signaling pathway	CM exclusivo
N-terminal protein amino acid modification	CM exclusivo
organelle localization by membrane tethering	CM exclusivo
purine ribonucleoside monophosphate metabolic process	CM exclusivo
synapse maturation	CM exclusivo
hematopoietic progenitor cell differentiation	CM exclusivo
fibroblast growth factor receptor signaling pathway	CM exclusivo
sterol metabolic process	CM exclusivo
mitochondrial genome maintenance	CM exclusivo
regulation of mitochondrial fission	CM exclusivo
regulation of postsynapse organization	CM exclusivo
porphyrin-containing compound biosynthetic process	CM exclusivo
ribonucleoside monophosphate biosynthetic process	CM exclusivo
tetrapyrrole biosynthetic process	CM exclusivo
pigment cell differentiation	CM exclusivo
regulation of aerobic respiration	CM exclusivo
polyol biosynthetic process	CM exclusivo
positive regulation of MAPK cascade	CM exclusivo
fibroblast proliferation	CM exclusivo
actomyosin structure organization	CM exclusivo
regulation of organelle assembly	CM exclusivo
L-alpha-amino acid transmembrane transport	CM exclusivo
negative regulation of proteolysis involved in protein catabolic process	CM exclusivo
response to lead ion	CM exclusivo
positive regulation of mitochondrial fission	CM exclusivo
striated muscle adaptation	CM exclusivo
response to cocaine	CM exclusivo
pigment biosynthetic process	CM exclusivo
intracellular pH reduction	CM exclusivo
respiratory system process	CM exclusivo
telomere organization	CM exclusivo
transcription initiation at RNA polymerase II promoter	CM exclusivo
positive regulation of secretion	CM exclusivo
positive regulation of autophagy	CM exclusivo
response to ionizing radiation	CM exclusivo
regulation of protein stability	CM exclusivo
mesonephros development	CM exclusivo
nuclear receptor-mediated signaling pathway	CM exclusivo
aromatic amino acid metabolic process	CM exclusivo
fatty-acyl-CoA metabolic process	CM exclusivo
positive regulation of nucleotide metabolic process	CM exclusivo
dopaminergic neuron differentiation	CM exclusivo
positive regulation of purine nucleotide metabolic process	CM exclusivo
RNA-templated DNA biosynthetic process	CM exclusivo
vasodilation	CM exclusivo
outflow tract septum morphogenesis	CM exclusivo
mitotic recombination	CM exclusivo
protein catabolic process in the vacuole	CM exclusivo
secretory granule localization	CM exclusivo
secondary palate development	CM exclusivo
regulation of synapse maturation	CM exclusivo
regulation of protein localization to plasma membrane	CM exclusivo
ventricular septum development	CM exclusivo
glycogen metabolic process	CM exclusivo
vacuolar acidification	CM exclusivo
forebrain neuron development	CM exclusivo
synaptic vesicle membrane organization	CM exclusivo
positive regulation of synaptic transmission, glutamatergic	CM exclusivo
neuron projection arborization	CM exclusivo
regulation of response to oxidative stress	CM exclusivo
regulation of peptide hormone secretion	CM exclusivo
synaptic transmission, dopaminergic	CM exclusivo
heme biosynthetic process	CM exclusivo
neuromuscular synaptic transmission	CM exclusivo
positive regulation of multicellular organism growth	CM exclusivo
cell-cell signaling involved in cardiac conduction	CM exclusivo
response to manganese ion	CM exclusivo
cell migration in hindbrain	CM exclusivo
cardiolipin metabolic process	CM exclusivo
anatomical structure arrangement	CM exclusivo
meiotic sister chromatid cohesion	CM exclusivo
replicative senescence	CM exclusivo
regulation of carbohydrate metabolic process	CM exclusivo
iron ion transport	CM exclusivo
nuclear envelope organization	CM exclusivo
regulation of actin filament organization	CM exclusivo
RNA modification	CM exclusivo
ventricular cardiac muscle tissue morphogenesis	CM exclusivo
regulation of reactive oxygen species biosynthetic process	CM exclusivo
regulation of respiratory gaseous exchange by nervous system process	CM exclusivo
galactose metabolic process	CM exclusivo
pyruvate family amino acid metabolic process	CM exclusivo
somatic hypermutation of immunoglobulin genes	CM exclusivo
thalamus development	CM exclusivo
maintenance of sister chromatid cohesion	CM exclusivo
maintenance of mitotic sister chromatid cohesion	CM exclusivo
atrioventricular canal development	CM exclusivo
positive regulation of astrocyte differentiation	CM exclusivo
regulation of resting membrane potential	CM exclusivo
prepulse inhibition	CM exclusivo
Golgi lumen acidification	CM exclusivo
regulation of lysosome organization	CM exclusivo
myeloid cell differentiation	CM exclusivo
regulation of postsynaptic membrane neurotransmitter receptor levels	CM exclusivo
response to vitamin	CM exclusivo
regulation of protein catabolic process	CM exclusivo
vesicle budding from membrane	CM exclusivo
vascular transport	CM exclusivo
protein localization to synapse	CM exclusivo
transport across blood-brain barrier	CM exclusivo
regulation of miRNA transcription	CM exclusivo
nephron morphogenesis	CM exclusivo
regulation of glial cell proliferation	CM exclusivo
positive regulation of SMAD protein signal transduction	CM exclusivo
ER-nucleus signaling pathway	CM exclusivo
cellular response to oxygen levels	CM exclusivo
meiotic spindle organization	CM exclusivo
mitochondrial DNA metabolic process	CM exclusivo
negative regulation of telomere maintenance via telomerase	CM exclusivo
cell proliferation involved in kidney development	CM exclusivo
quinone metabolic process	CM exclusivo
organic cation transport	CM exclusivo
osteoblast differentiation	CM exclusivo
negative regulation of carbohydrate metabolic process	CM exclusivo
response to pain	CM exclusivo
transepithelial transport	CM exclusivo
dendrite extension	CM exclusivo
morphogenesis of an epithelial sheet	CM exclusivo
regulation of microtubule polymerization	CM exclusivo
regulation of peptide secretion	CM exclusivo
folic acid-containing compound metabolic process	CM exclusivo
hyperosmotic response	CM exclusivo
GMP metabolic process	CM exclusivo
vesicle tethering	CM exclusivo
regulation of post-transcriptional gene silencing by regulatory ncRNA	CM exclusivo
developmental pigmentation	CM exclusivo
positive regulation of intracellular transport	CM exclusivo
monoamine transport	CM exclusivo
miRNA transcription	CM exclusivo
L-amino acid catabolic process	CM exclusivo
regulated exocytosis	CM exclusivo
DNA-templated transcription elongation	CM exclusivo
porphyrin-containing compound metabolic process	CM exclusivo
regulation of insulin secretion	CM exclusivo
mitophagy	CM exclusivo
behavioral fear response	CM exclusivo
positive regulation of neurotransmitter secretion	CM exclusivo
axonal transport of mitochondrion	CM exclusivo
spinal cord patterning	CM exclusivo
IMP metabolic process	CM exclusivo
tetrahydrofolate metabolic process	CM exclusivo
cell proliferation involved in heart morphogenesis	CM exclusivo
ureter development	CM exclusivo
neurotransmitter-gated ion channel clustering	CM exclusivo
regulation of cell proliferation involved in heart morphogenesis	CM exclusivo
vesicle fusion	CM exclusivo
negative regulation of cell projection organization	CM exclusivo
cardiac muscle tissue morphogenesis	CM exclusivo
myeloid cell development	CM exclusivo
vasculogenesis	CM exclusivo
transcription by RNA polymerase III	CM exclusivo
regulation of peptide transport	CM exclusivo
somatic diversification of immune receptors	CM exclusivo
nephron tubule morphogenesis	CM exclusivo
organelle disassembly	CM exclusivo
cellular response to light stimulus	CM exclusivo
DNA biosynthetic process	CM exclusivo
positive regulation of microtubule polymerization or depolymerization	CM exclusivo
positive regulation of protein-containing complex disassembly	CM exclusivo
response to antibiotic	CM exclusivo
lens fiber cell differentiation	CM exclusivo
cellular response to transforming growth factor beta stimulus	CM exclusivo
regulation of Ras protein signal transduction	CM exclusivo
digestive tract morphogenesis	CM exclusivo
catecholamine secretion	CM exclusivo
telomere maintenance	CM exclusivo
positive regulation of canonical Wnt signaling pathway	CM exclusivo
cardiac conduction	CM exclusivo
regeneration	CM exclusivo
dense core granule localization	CM exclusivo
phosphatidylinositol-3-phosphate biosynthetic process	CM exclusivo
response to salt	CM exclusivo
response to nutrient	CM exclusivo
regulation of synapse assembly	CM exclusivo
regulation of superoxide metabolic process	CM exclusivo
postsynaptic modulation of chemical synaptic transmission	CM exclusivo
urea metabolic process	CM exclusivo
regulation of SNARE complex assembly	CM exclusivo
regulation of dendritic spine maintenance	CM exclusivo
regulation of telomere capping	CM exclusivo
cellular response to reactive oxygen species	CM exclusivo
response to gamma radiation	CM exclusivo
proline metabolic process	CM exclusivo
neurofilament cytoskeleton organization	CM exclusivo
regulation of ER to Golgi vesicle-mediated transport	CM exclusivo
RISC complex assembly	CM exclusivo
cellular response to manganese ion	CM exclusivo
otic vesicle morphogenesis	CM exclusivo
positive regulation of transcription of nucleolar large rRNA by RNA polymerase I	CM exclusivo
positive regulation of extrinsic apoptotic signaling pathway in absence of ligand	CM exclusivo
cellular response to UV	CM exclusivo
insulin receptor signaling pathway	CM exclusivo
endocardial cushion formation	CM exclusivo
establishment of mitochondrion localization, microtubule-mediated	CM exclusivo
fatty-acyl-CoA biosynthetic process	CM exclusivo
mitochondrion transport along microtubule	CM exclusivo
miRNA metabolic process	CM exclusivo
response to osmotic stress	CM exclusivo
positive regulation of muscle cell differentiation	CM exclusivo
branching involved in ureteric bud morphogenesis	CM exclusivo
endoderm formation	CM exclusivo
dopamine transport	CM exclusivo
negative regulation of microtubule polymerization or depolymerization	CM exclusivo
maintenance of protein localization in organelle	CM exclusivo
cholesterol biosynthetic process	CM exclusivo
cellular response to heat	CM exclusivo
secondary alcohol biosynthetic process	CM exclusivo
DNA-templated transcription initiation	CM exclusivo
organelle membrane fusion	CM exclusivo
mitotic cytokinesis	CM exclusivo
temperature homeostasis	CM exclusivo
mammary gland development	CM exclusivo
vesicle transport along microtubule	CM exclusivo
post-Golgi vesicle-mediated transport	CM exclusivo
primary neural tube formation	CM exclusivo
regulation of miRNA metabolic process	CM exclusivo
aortic valve morphogenesis	CM exclusivo
negative regulation of ubiquitin-dependent protein catabolic process	CM exclusivo
endoplasmic reticulum to Golgi vesicle-mediated transport	CM exclusivo
negative regulation of neuron projection development	CM exclusivo
protein localization to chromosome	CM exclusivo
regulation of glial cell differentiation	CM exclusivo
nephron epithelium morphogenesis	CM exclusivo
positive regulation of nuclear division	CM exclusivo
vesicle cytoskeletal trafficking	CM exclusivo
regulation of hormone secretion	CM exclusivo
asymmetric cell division	CM exclusivo
regulation of skeletal muscle contraction	CM exclusivo
response to magnesium ion	CM exclusivo
osteoclast development	CM exclusivo
regulation of odontogenesis	CM exclusivo
parasympathetic nervous system development	CM exclusivo
pericardium development	CM exclusivo
catecholamine uptake	CM exclusivo
bone cell development	CM exclusivo
glutamatergic neuron differentiation	CM exclusivo
ureteric bud morphogenesis	CM exclusivo
regulation of extent of cell growth	CM exclusivo
glutamate metabolic process	CM exclusivo
regulation of astrocyte differentiation	CM exclusivo
establishment of mitochondrion localization	CM exclusivo
regulation of gene silencing by regulatory ncRNA	CM exclusivo
negative regulation of gene expression, epigenetic	CM exclusivo
negative regulation of small molecule metabolic process	CM exclusivo
embryonic cranial skeleton morphogenesis	CM exclusivo
response to xenobiotic stimulus	CM exclusivo
dopamine secretion	CM exclusivo
innervation	CM exclusivo
inclusion body assembly	CM exclusivo
mitochondrial calcium ion transmembrane transport	CM exclusivo
lysosomal lumen acidification	CM exclusivo
nucleolar large rRNA transcription by RNA polymerase I	CM exclusivo
positive regulation of neurotransmitter transport	CM exclusivo
renal filtration cell differentiation	CM exclusivo
podocyte differentiation	CM exclusivo
positive regulation of transferase activity	CM exclusivo
formation of primary germ layer	CM exclusivo
tissue migration	CM exclusivo
regulation of signal transduction by p53 class mediator	CM exclusivo
response to axon injury	CM exclusivo
protein monoubiquitination	CM exclusivo
hexose catabolic process	CM exclusivo
regulation of lipid metabolic process	CM exclusivo
cellular component maintenance	CM exclusivo
neural tube formation	CM exclusivo
negative regulation of synaptic transmission	CM exclusivo
negative regulation of proteasomal protein catabolic process	CM exclusivo
positive regulation of telomere maintenance	CM exclusivo
mitotic spindle assembly	CM exclusivo
autophagosome organization	CM exclusivo
rRNA transcription	CM exclusivo
tRNA methylation	CM exclusivo
negative regulation of proteasomal ubiquitin-dependent protein catabolic process	CM exclusivo
neurotrophin signaling pathway	CM exclusivo
response to acid chemical	CM exclusivo
osteoclast differentiation	CM exclusivo
regulation of circadian rhythm	CM exclusivo
positive regulation of neuron apoptotic process	CM exclusivo
mesonephric tubule morphogenesis	CM exclusivo
ventricular cardiac muscle tissue development	CM exclusivo
regulation of oxidoreductase activity	CM exclusivo
cardiac cell development	CM exclusivo
regulation of DNA biosynthetic process	CM exclusivo
response to transforming growth factor beta	CM exclusivo
epithelial to mesenchymal transition involved in endocardial cushion formation	CM exclusivo
microglia differentiation	CM exclusivo
cerebellar Purkinje cell layer formation	CM exclusivo
cellular response to potassium ion	CM exclusivo
response to L-leucine	CM exclusivo
sphingosine biosynthetic process	CM exclusivo
sphingoid biosynthetic process	CM exclusivo
calcium ion-regulated exocytosis of neurotransmitter	CM exclusivo
peripheral nervous system neuron development	CM exclusivo
neuroblast division	CM exclusivo
regulation of long-term synaptic depression	CM exclusivo
NADP metabolic process	CM exclusivo
potassium ion import across plasma membrane	CM exclusivo
negative regulation of fibroblast proliferation	CM exclusivo
mesodermal cell differentiation	CM exclusivo
phosphatidylinositol 3-kinase/protein kinase B signal transduction	CM exclusivo
gland morphogenesis	CM exclusivo
positive regulation of kinase activity	CM exclusivo
blood vessel remodeling	CM exclusivo
aldehyde metabolic process	CM exclusivo
IMP biosynthetic process	CM exclusivo
DNA alkylation repair	CM exclusivo
ER overload response	CM exclusivo
deoxyribonucleoside metabolic process	CM exclusivo
heparin proteoglycan biosynthetic process	CM exclusivo
response to histamine	CM exclusivo
elastic fiber assembly	CM exclusivo
Bergmann glial cell differentiation	CM exclusivo
ventral spinal cord interneuron fate commitment	CM exclusivo
cell fate commitment involved in pattern specification	CM exclusivo
prostate gland growth	CM exclusivo
epithelial cell proliferation involved in prostate gland development	CM exclusivo
lung secretory cell differentiation	CM exclusivo
L-aspartate transmembrane transport	CM exclusivo
positive regulation of type 2 mitophagy	CM exclusivo
negative regulation of cell-cell adhesion mediated by cadherin	CM exclusivo
negative regulation of mesenchymal cell apoptotic process	CM exclusivo
glycosphingolipid metabolic process	CM exclusivo
collagen-activated tyrosine kinase receptor signaling pathway	CM exclusivo
mesenchyme morphogenesis	CM exclusivo
regulation of action potential	CM exclusivo
protein localization to cell junction	CM exclusivo
membrane depolarization during action potential	CM exclusivo
negative regulation of telomere maintenance via telomere lengthening	CM exclusivo
cellular component assembly involved in morphogenesis	CM exclusivo
cellular anatomical entity morphogenesis	CM exclusivo
response to temperature stimulus	CM exclusivo
cardiac right ventricle morphogenesis	CM exclusivo
aspartate transmembrane transport	CM exclusivo
regulation of neurotransmitter uptake	CM exclusivo
cellular hyperosmotic response	CM exclusivo
phosphate ion transport	CM exclusivo
positive regulation of nucleotide catabolic process	CM exclusivo
positive regulation of purine nucleotide catabolic process	CM exclusivo
mitochondrial cytochrome c oxidase assembly	CM exclusivo
response to muscle stretch	CM exclusivo
purine-containing compound salvage	CM exclusivo
positive regulation of glycolytic process	CM exclusivo
glomerular epithelial cell differentiation	CM exclusivo
endocardial cushion morphogenesis	CM exclusivo
protein localization to chromosome, centromeric region	CM exclusivo
regulation of calcium ion transport	CM exclusivo
adaptive thermogenesis	CM exclusivo
regulation of proteolysis involved in protein catabolic process	CM exclusivo
nuclear membrane organization	CM exclusivo
superoxide metabolic process	CM exclusivo
regulation of actin filament length	CM exclusivo
ceramide biosynthetic process	CM exclusivo
protein destabilization	CM exclusivo
regulation of chondrocyte differentiation	CM exclusivo
response to nicotine	CM exclusivo
response to amphetamine	CM exclusivo
glandular epithelial cell differentiation	CM exclusivo
snRNA processing	CM exclusivo
anoikis	CM exclusivo
response to ischemia	CM exclusivo
nucleobase-containing compound transport	CM exclusivo
positive regulation of mitotic cell cycle	CM exclusivo
regulation of organ growth	CM exclusivo
steroid metabolic process	CM exclusivo
positive regulation of protein secretion	CM exclusivo
regulation of protein localization to cell surface	CM exclusivo
synaptic vesicle fusion to presynaptic active zone membrane	CM exclusivo
pharyngeal system development	CM exclusivo
regulation of miRNA-mediated gene silencing	CM exclusivo
cardiac left ventricle morphogenesis	CM exclusivo
pyrimidine nucleobase metabolic process	CM exclusivo
oligosaccharide catabolic process	CM exclusivo
spinal cord dorsal/ventral patterning	CM exclusivo
autophagy of peroxisome	CM exclusivo
peripheral nervous system neuron differentiation	CM exclusivo
negative regulation of lyase activity	CM exclusivo
regulation of protein complex stability	CM exclusivo
proton-transporting two-sector ATPase complex assembly	CM exclusivo
nitrogen cycle metabolic process	CM exclusivo
regulation of miRNA processing	CM exclusivo
regulation of organic acid transport	CM exclusivo
cellular response to calcium ion	CM exclusivo
exocytosis	CM exclusivo
translational elongation	CM exclusivo
negative regulation of muscle cell differentiation	CM exclusivo
neuron recognition	CM exclusivo
positive regulation of peptidyl-serine phosphorylation	CM exclusivo
semaphorin-plexin signaling pathway	CM exclusivo
regulation of embryonic development	CM exclusivo
response to heat	CM exclusivo
vascular process in circulatory system	CM exclusivo
regulation of oxidative phosphorylation	CM exclusivo
vascular associated smooth muscle contraction	CM exclusivo
corpus callosum development	CM exclusivo
regulation of dendritic spine development	CM exclusivo
muscle adaptation	CM exclusivo
tRNA wobble base modification	CM exclusivo
dosage compensation by inactivation of X chromosome	CM exclusivo
purine nucleotide salvage	CM exclusivo
regulation of integrin-mediated signaling pathway	CM exclusivo
signal transduction by p53 class mediator	CM exclusivo
regulation of heart contraction	CM exclusivo
positive regulation of cytoskeleton organization	CM exclusivo
aminoglycan metabolic process	CM exclusivo
cardiac conduction system development	CM exclusivo
positive regulation of axon extension	CM exclusivo
sequestering of calcium ion	CM exclusivo
negative regulation of protein catabolic process	CM exclusivo
response to steroid hormone	CM exclusivo
positive regulation of mitotic cell cycle phase transition	CM exclusivo
RNA 3'-end processing	CM exclusivo
negative regulation of protein polymerization	CM exclusivo
regulation of cartilage development	CM exclusivo
midgut development	CM exclusivo
UV protection	CM exclusivo
glyceraldehyde-3-phosphate metabolic process	CM exclusivo
positive regulation of catecholamine secretion	CM exclusivo
negative regulation of cell adhesion mediated by integrin	CM exclusivo
skin morphogenesis	CM exclusivo
cellular response to antibiotic	CM exclusivo
podocyte development	CM exclusivo
dense core granule cytoskeletal transport	CM exclusivo
regulation of ferroptosis	CM exclusivo
dense core granule transport	CM exclusivo
regulation of axon guidance	CM exclusivo
regulation of neuromuscular junction development	CM exclusivo
regulation of lymphoid progenitor cell differentiation	CM exclusivo
positive regulation of integrin-mediated signaling pathway	CM exclusivo
ventricular septum morphogenesis	CM exclusivo
ERBB signaling pathway	CM exclusivo
Notch signaling pathway	CM exclusivo
Golgi to plasma membrane transport	CM exclusivo
neural tube closure	CM exclusivo
regulation of autophagosome assembly	CM exclusivo
response to monoamine	CM exclusivo
response to catecholamine	CM exclusivo
cell communication by electrical coupling	CM exclusivo
vesicle fusion to plasma membrane	CM exclusivo
brain-derived neurotrophic factor receptor signaling pathway	CM exclusivo
hydrogen peroxide metabolic process	CM exclusivo
monosaccharide catabolic process	CM exclusivo
regulation of actin polymerization or depolymerization	CM exclusivo
regulation of small GTPase mediated signal transduction	CM exclusivo
transforming growth factor beta receptor signaling pathway	CM exclusivo
fat cell differentiation	CM exclusivo
regulation of epithelial to mesenchymal transition	CM exclusivo
cytoskeleton-dependent cytokinesis	CM exclusivo
intracellular receptor signaling pathway	CM exclusivo
cellular response to insulin stimulus	CM exclusivo
sterol biosynthetic process	CM exclusivo
synaptic vesicle maturation	CM exclusivo
response to increased oxygen levels	CM exclusivo
ERK1 and ERK2 cascade	CM exclusivo
regulation of DNA-templated transcription elongation	CM exclusivo
tRNA wobble uridine modification	CM exclusivo
tyrosine metabolic process	CM exclusivo
amino-acid betaine metabolic process	CM exclusivo
muscle cell fate commitment	CM exclusivo
regulation of regulatory ncRNA processing	CM exclusivo
synaptic vesicle clustering	CM exclusivo
cardiac muscle cell development	CM exclusivo
tube closure	CM exclusivo
regulation of potassium ion transmembrane transport	CM exclusivo
negative regulation of secretion by cell	CM exclusivo
somatic diversification of immunoglobulins	CM exclusivo
positive regulation of small GTPase mediated signal transduction	CM exclusivo
regulation of muscle contraction	CM exclusivo
negative regulation of secretion	CM exclusivo
glycerol ether metabolic process	CM exclusivo
positive regulation of glycoprotein biosynthetic process	CM exclusivo
optic nerve development	CM exclusivo
ether lipid metabolic process	CM exclusivo
branching involved in salivary gland morphogenesis	CM exclusivo
membrane depolarization during cardiac muscle cell action potential	CM exclusivo
regulation of synaptic vesicle endocytosis	CM exclusivo
astrocyte development	CM exclusivo
regulation of mitotic spindle organization	CM exclusivo
collagen-activated signaling pathway	CM exclusivo
extracellular matrix assembly	CM exclusivo
cell communication involved in cardiac conduction	CM exclusivo
positive regulation of stem cell proliferation	CM exclusivo
androgen receptor signaling pathway	CM exclusivo
response to cadmium ion	CM exclusivo
pigment metabolic process	CM exclusivo
positive regulation of protein localization to nucleus	CM exclusivo
regulation of cell morphogenesis	CM exclusivo
cytosolic transport	CM exclusivo
gonad development	CM exclusivo
myofibril assembly	CM exclusivo
mechanoreceptor differentiation	CM exclusivo
regulation of mitochondrial membrane potential	CM exclusivo
cellular response to ionizing radiation	CM exclusivo
negative regulation of protein depolymerization	CM exclusivo
animal organ maturation	CM exclusivo
regulation of presynapse assembly	CM exclusivo
epithelium migration	CM exclusivo
negative regulation of protein localization	CM exclusivo
regulation of ossification	CM exclusivo
glycoprotein catabolic process	CM exclusivo
microtubule organizing center organization	CM exclusivo
regulation of axon extension	CM exclusivo
cellular response to osmotic stress	CM exclusivo
response to dopamine	CM exclusivo
base-excision repair	CM exclusivo
miRNA processing	CM exclusivo
superoxide anion generation	CM exclusivo
skeletal muscle tissue regeneration	CM exclusivo
response to superoxide	CM exclusivo
gastrulation with mouth forming second	CM exclusivo
protein quality control for misfolded or incompletely synthesized proteins	CM exclusivo
nucleotide salvage	CM exclusivo
glomerular epithelium development	CM exclusivo
negative regulation of miRNA transcription	CM exclusivo
negative regulation of stem cell proliferation	CM exclusivo
isoprenoid metabolic process	CM exclusivo
retrograde vesicle-mediated transport, Golgi to endoplasmic reticulum	CM exclusivo
microtubule depolymerization	CM exclusivo
AMP biosynthetic process	CM exclusivo
mitochondrial DNA replication	CM exclusivo
glycine metabolic process	CM exclusivo
carnitine metabolic process	CM exclusivo
ubiquitin recycling	CM exclusivo
ventral spinal cord interneuron differentiation	CM exclusivo
cerebellar Purkinje cell differentiation	CM exclusivo
positive regulation of Rac protein signal transduction	CM exclusivo
cell migration involved in gastrulation	CM exclusivo
positive regulation of membrane potential	CM exclusivo
macrophage proliferation	CM exclusivo
vitamin D receptor signaling pathway	CM exclusivo
cellular response to salt stress	CM exclusivo
glomerular epithelial cell development	CM exclusivo
ferroptosis	CM exclusivo
spontaneous synaptic transmission	CM exclusivo
carbohydrate derivative transport	CM exclusivo
inner ear receptor cell differentiation	CM exclusivo
positive regulation of protein catabolic process	CM exclusivo
arginine metabolic process	CM exclusivo
sex-chromosome dosage compensation	CM exclusivo
response to salt stress	CM exclusivo
removal of superoxide radicals	CM exclusivo
regulation of superoxide anion generation	CM exclusivo
snRNA 3'-end processing	CM exclusivo
AMP metabolic process	CM exclusivo
cellular response to vitamin D	CM exclusivo
regulation of DNA damage checkpoint	CM exclusivo
skin development	CM exclusivo
regulation of animal organ morphogenesis	CM exclusivo
virion assembly	CM exclusivo
regulation of response to nutrient levels	CM exclusivo
potassium ion homeostasis	CM exclusivo
long-term synaptic depression	CM exclusivo
regulation of presynapse organization	CM exclusivo
regulation of transcription regulatory region DNA binding	CM exclusivo
myelin maintenance	CM exclusivo
aldehyde biosynthetic process	CM exclusivo
lateral mesoderm development	CM exclusivo
neuroendocrine cell differentiation	CM exclusivo
dopamine uptake	CM exclusivo
response to macrophage colony-stimulating factor	CM exclusivo
positive regulation of viral process	CM exclusivo
regulation of cold-induced thermogenesis	CM exclusivo
neutral amino acid transport	CM exclusivo
NADH metabolic process	CM exclusivo
modified amino acid transport	CM exclusivo
positive regulation of striated muscle cell differentiation	CM exclusivo
positive regulation of organic acid transport	CM exclusivo
modified amino acid biosynthetic process	CM exclusivo
postsynaptic density organization	CM exclusivo
regulation of extrinsic apoptotic signaling pathway in absence of ligand	CM exclusivo
actin polymerization or depolymerization	CM exclusivo
endosome to lysosome transport	CM exclusivo
release of sequestered calcium ion into cytosol	CM exclusivo
development of primary sexual characteristics	CM exclusivo
peptidyl-lysine modification	CM exclusivo
response to oxygen radical	CM exclusivo
ganglioside metabolic process	CM exclusivo
regulation of animal organ formation	CM exclusivo
hypothalamus development	CM exclusivo
phosphatidylethanolamine metabolic process	CM exclusivo
bone maturation	CM exclusivo
negative regulation of amyloid-beta formation	CM exclusivo
regulation of receptor localization to synapse	CM exclusivo
positive regulation of telomere maintenance via telomere lengthening	CM exclusivo
inhibitory synapse assembly	CM exclusivo
regulation of intracellular protein transport	CM exclusivo
cold-induced thermogenesis	CM exclusivo
regulation of potassium ion transport	CM exclusivo
